111111111111
1C00E00C0001
10P101101101
100000000001
111111111111
100001000001
100001000001
100001000001
100001000001
100001000001
100001000001
100001000001
100001000001
100000000001
111111111111
