111111111111111111111111111111111111
1P00000000C0010000000000000000000001
100011111111101000001111111111110001
100010000000001000001000000000010001
100010111111101111101011111111010001
100010100000100000001010000001010001
100010101110101111101010111101010001
100000101000100000001010100001010001
111110101011111111101010101111010001
100000001000000000001000100000010001
101111111011111111101111101111110001
100000000010000000001000001000000001
101111111110111111101011111011111101
1000000000001000000010100000100000E1
111111111111111111111111111111111111
