1111111111
1000000001
1111111111
10P0C01101
10111C0E01
1111111111
1000000001
1111111111

