111111111111111111111111111111111111
100000000000000000000000000000000001
100000000000000000000000000000000001
100111111111111111111111111111111001
1001111P00000000000000C1111111111001
100111111111111111111101111111111001
100111111111111111111101111111111001
1001111111111111111111E1111111111001
100111111111111111111111111111111001
100000000000000000000000000000000001
100000000000000000000000000000000001
111111111111111111111111111111111111
