111111111111
1C0E000C0001
10P10M101101
100000000001
111111111111
100001000001
100001000001
100001000001
100001000001
100001000001
100001000001
100001000001
100001000001
100000000001
111111111111
